Adieu = cognac, Grand Marnier, vanilla liqueur
Alexander No. 2 = brandy, white crème de caco, heavy cream
Amber Cloud = cognac, Galliano
American Beauty = brandy, extra dry vermouth, orange juice, ruby port, white crème de menthe, grenadine
Amour Sanglant = cognac, cherry brandy, vanilla liqueur, blood-orange juice
Angel's Dream = maraschino liqueur, Parfait Amour, cognac
Brandy Alexander = brandy, brown crème de caco, heavy cream
Sidecar = brandy, Cointreau, lemon juice
Stinger = brandy, white crème de menthe
Collins = gin, lemon juice, gomme syrup, club soda
Classic Martini = gin, extra dry vermouth
Pink Gin = gin, Angostura bitters
Raffles Singapore Sling = gin, cherry brandy, Cointreau, Bénédictine, lime juice, orange juice, pineapple juice
Singapore Sling = gin, cherry brandy, lemon juice, club soda
Caipirinha = cachaça, lime, superfine sugar
Daiquiri = white rum, lime juice, gomme syrup
Long Island Iced Tea = light rum, vodka, gin, tequila, Cointreau, lime juice, cola
Mai Tai = dark rum, golden rum, triple sec, Orgeat, lime juice, grenadine
Mojito = white rum, superfine sugar, lime juice, mint, club soda, Angostura bitters
Piña Colada = white rum, pineapple juice, coconut cream, crushed ice
Smokey Rum Fashioned = Scotch whiskey, tobacco syrup, orange, Zacapa 23 rum
Zombie = white rum, golden rum, dark rum, cherry brandy, apricot brandy, pineapple juice, orange juice, lime juice, Orgeat, 151 proof Demerara rum
Margarita = silver tequila, lime juice, Cointreau
Tequila Sunrise = tequila, orange juice, grenadine
Vampiro = silver tequila, tomato juice, orange juice, honey, lime juice, onion, red hot chili Worcestershire sauce, salt
Bloody Mary = vodka, tomato juice, lemon juice, celery salt, Worcestershire sauce, Tabasco sauce, ground black pepper
Cosmopolitan = vodka, Cointreau, cranberry juice, lime juice
Moscow Mule = vodka, lime juice, ginger beer
Boston Flip = bourbon, Madeira, egg, gomme syrup
Manhattan = rye whiskey, sweet vermouth, Angostura bitters
Dry Manhattan = Canadian Club whiskey, dry vermouth, Angostura bitters
Perfect Manhattan = Canadian Club whiskey, dry vermouth, sweet vermouth, Angostura bitters
Mint Julep = bourbon, mint, superfine sugar, water, club soda
Old-Fashioned = bourbon, sugar cube, Angostura bitters, club soda
Sazerac = rye whiskey, absinthe, peychaud bitters, sugar cube, club soda
Bellini = white peach purée, champagne
Classic Champagne Cocktail = cognac, Angostura bitters, sugar cube, champagne
Kir = crème de cassis, dry white wine
Americano = Campari, sweet vermouth, club soda
Negroni = Campari, gin, sweet vermouth, club soda
Fish House Punch = peach brandy, cognac, dark rum, lemon juice, gomme syrup, club soda
Planter's Punch = Myers's dark rum, Angostura bitters, lemon juice, gomme syrup
Planter's Punch No. 2 = Myers's dark rum, white rum, Cointreau, pineapple juice, orange juice, lime juice, grenadine
Sangria = Spanish red wine, Spanish brandy, triple sec, superfine sugar, lemon juice, orange juice, apple, orange, lemon, lime, club soda
Pimm's No. 1 Cup = Pimm's No. 1 Cup, lemon, orange, cucumber, mint
Eggnog = egg, brandy, dark rum, milk, gomme syrup
Pousse-Café = grenadine, green crème de menthe, Galliano, kummel, brandy
Blue Blazer = whiskey, water, superfine sugar
Irish Coffee = brown sugar, Irish whiskey, coffee, whipped cream